R 1080 480
WE /Users/kbenlyaz/Desktop/tt.xpm
EA /Users/kbenlyaz/Desktop/wall11.xpm
SO /Users/kbenlyaz/Desktop/wall33.xpm
NO /Users/kbenlyaz/Desktop/wall22.xpm
S /Users/kbenlyaz/Desktop/barrel.xpm

C 135,190,225
F 90,96,90

11111111111111
10000000000001
10000000000001111111111
11111000000000000000001
     11111000000000011111111
        100000000001
        100000000001     111111
        11111111000111111120021
        111111110000000000000011111111
                111111100000000000000111111
              110000000000000000000001
    111111111100000000000000111111111111111111
    10000000000000000000000000000000000000001
    100000000000000000000000S000000000000001
    1000000000000020000000000000000000000001
    1000000000000022222220000000000000000001
    1000000000000020000000000000000000000001
    1000000000000020000000000000000000000001
    1000000000000000000000000000000000000001
    1000000000000000000000000000000000000001
    1000000000000000000000000000000000000001
    1000000000000000000000000000000000000001
    1000000000000000000000000000000000000001
    10000001111111111111100111111111111111111
    10000001            10001
    1000000011111111    100001
    10000000000000001111110001
    10011111111110000000000001
    1001        11111111111001
    1001                  1001
    1001                111001   11111111111111111111
    1011                100001111100000000000000000011111111111111111111111111111
    1001                100000000000000000000000000000000000000000000000000000001
    1001                100011111111111111111111111111111111111111111111111111111
    10001               11111
    100001
    1110001
    10000001
1111000000001
1000000000001
1000000000001
1222222222221
11111111111111