R 400 800
NO /Users/kbenlyaz/Desktop/wall0.xpm
SO /Users/kbenlyaz/Desktop/wall2.xpm
WE /Users/kbenlyaz/Desktop/wall3.xpm
EA /Users/kbenlyaz/Desktop/wall4.xpm
S /Users/kbenlyaz/Desktop/ninja.xpm
F 148,112,214
C 255,102,102


111111111111111111
 10001001000001     
 1000000100001111111111
11111000100001000001
     11111111111111111
        1000000011
        10002000001     11111
        11111111000111111120011
        11111111000000000000011111111 
                111111100000000000000111111         
              110000000000000000000001                        
    111111111100000000000000111111111111111111
    1111111111111111111111111
    1111111111111111111111111
    1000000000000000000000001
    100000000000200000W0000001
    1000000000000000000000001
    1000000111111111111110011
    10000001            10001
    1000000011111111    100001
    10000000000000001111110001
    10011111111110000000000001
    1001        11111111111001
    1001                  1001
    1001                111001   11111111111111111111
    1011                100001111100000000000000000011111111111111111111111111111
    1001                100000000000000000000000000000000000000000000000000000001
    1001                100011111111111111111111111111111111111111111111111111111
    10001               11111
    100001
    1110001
    10000001
1111000110001
10000000001111
1000000111111
10011111111111
11111111111111