R 800 800
WE ./wall7.xpm
EA ./wall7.xpm
SO ./wall7.xpm
NO ./wall7.xpm
S ./barrel.xpm
C 135,190,200
F 100,100,100

11111111111111
 1111111111111111111111
110000000000001
110000000000001111111111
11111000000000000000001
     11111000000000011111111
        100000000001
        100000000001     111111
        11111111000111111120021
        111111110000000000000011111111
                1100000100000000000000111111
              110000000000000000111111
    111111111100000000000000111111111111111111
         1111111110000111111111111
           111111100000011111111
    111111111100000000000000111111111111111111
    10000000000000000000000000000000000000001
    1000000000000000000000000000000000000011
    10000000000000200S0000000000000000000001
    1000000000000022222220000000000000000001
    1000000000000020000000000000000000000001
    1000000000000020000000000000000000000001
    100000000000000000000000000000000000001
    1000000000000000000000000000000000000001
    1000000000000000000000000000000000000001
    1000000000000000000000000000000000000001
    1000000000000000000000000000000000000001
    10000001111111111111100111111111111111111
    10000001111111111111111110001
    10000000111111111111111100001
    10000000000000001111110001111
    10011111111110000000000001
    1001        11111111111001
    1001                  1001
    1001                111001   1111111111111111111
    1011                1000011111000000000000000000111111111111111111111111111111 11
    1001                100000000000000000000000000000000000000000000000000000001111
    1001                10001111111111111111111111111111111111111111111111111111111
    10001               11111
    100001
    1110001
    10000001
1111000000001
1000000000001
1000000000001
1222222222221 
11111111111111